C 220,100,0
NO  ./path_to_the_north_texture
SO  ./path_to_the_south_texture
F 0,5,0
WE ./path_to_the_west_texture
EA ./path_to_the_east_texture


1111111111
1000000001
100010S101
1000010001
1111111111
