    F 220    ,       0            , 1
        WE qweweweqwe
        SO        thisisatest
    EA  ./path_to_the_east_texture
    NO ./path_to_the_north_texture
        C 22    , 30 ,1  













              1 1   1      1 1 1   1
               101111111
               1111111111111111111111
               1111111111111111111111
               1111111111111111111111
               1111111111111111111111

   