


       C 0              ,     0         ,       0



 NO  ./path_to_the_north_texture



SO ./path_to_the_south_texture







F 0,5,0




       WE ./path_to_the_west_texture








EA ./path_to_the_east_texture

             111111111111111111111111
             100000000N110000000000001
             1011000001110000000000001
             10010000000000000000000011111111
             111111111011000001110000000000001
   11         100000000011000001110111111111111
1111011111111101110000001000111   11
11110111111111011101010010001     
11000000110101011100000010001
10000000000000001100000010001
10000000000000001101S10010001
1100000111010101111101111000111
1111011111110101 101111010001
11111111 1111111 111111111111      1
                                  101
                                   1