NO ./path_to_the_north_texture
SO                      thisisatest
WE qweweweqwe
EA  ./path_to_the_east_texture           









 F  220    ,       0            , 1
C 22    , 30 ,1   








111
        1111111111111111111111111
        1000000000110000000000001
        1011000001110000000000001
        1001000000000000000000001111
    111111111011000001110000000000001
    10000000001100000110111111111111
11110111111111011100000010001
11110111111111011101010010001
11000000110101011100000010001
10000000000000001100000010001
10000000000000001101010010001
110000011101010111110111100111
11110111 1110101 101111010001
11111111 1111111 111111011111
111111111111111111111111