



EA textures/wall3.png
NO textures/wall3.png




C       42,42,53

F 41,39,32

SO textures/wall3.png


WE textures/wall3.png



1111111111111111111111111   1111
1000000000110000000000001   10101
1D11000001110000000000001   1111
100100000000000000000000111111111111
1111111111111011000001110000000000001
1000000000110000011101111111111111111
11110111111111011101D100100001
11110111111111011100000010001
11000000110101011100000010001
10000000000000001100000010001
10000000000000001101D100D0001
11000001110101011111011110N0111
11110111 1110101 101111010001    1
    1       1 1   1    1 111
11111111 1111111 111111111111      

