



EA textures/wall.png
NO textures/wall.png




C       42,42,53

F 41,39,32

SO textures/wall.png


WE textures/wall.png



11111
10N1
 111