



EA ./path_to_the_east_texture
NO ./path_to_the_north_texture




C       0,0,0

F 0,5,0

SO ./path_to_the_south_texture


WE ./path_to_the_west_texture



1111111111111111111111111   1111
1000000000110000000000001   10101
1011000001110000000000001   1111
100100000000000000000000111111111111
1111111111111011000001110000000000001
1000000000110000011101111111111111111
11110111111111011100000010001
11110111111111011101010010001
11000000110101011100000010001
10000000000000001100000010001
10000000000000001101010000001
11000001110101011111011110N0111
11110111 1110101 101111010001    1
    1       1 1   1    1 111
11111111 1111111 111111111111      

