



EA textures/wall30.png
NO textures/wall30.png




C       16,38,24

F 45,64,53

SO textures/wall30.png


WE textures/wall30.png



1111111111111111111111111   1111
1000000000110000000000001   10101
1011000001110000000000001   1111
100100000000000000000000111111111111
1111111111111011000001110000000000001
1000000000110000011101111D11111111111
111101111111110111010100100001
11110111111111011100000010001
11000000110101011100000010001
10000000000000001100000010001
100000000000000011010100D0001
11000001110101011111011110N0111
11110111 1110101 101111010001    1
    1       1 1   1    1 111
11111111 1111111 111111111111      

