



EA textures/wall.png
NO textures/wall.png




C       42,42,53

F 41,39,32

SO textures/wall.png


WE textures/wall.png



1111111111111111111111111   1111
1000000000110000000000001  10101
1D11000001110000000000001   1111
100100000000000011111111111111111111111111111111111111
1000000000110000011D1D1D1D1D1D1D1D1D11D1D1D1D1D1D1D1D1
111111111111101100000000000000000000000000000000000001
111111111111101100000000000000000000000000000000000001
111111111111101100000000000000000000000N00000000000001
111101111111110111111111111111111111111111111111111111
111101111111110111000000100000000000000000000000000001
110000001101010111000000111111111111111111111111111111
10000000000000001100000010001
10000000000000001101D100D0001
1100000111010101111110111000111
11110111 1110101 101111010001    1
    1       1 1   1    1 111
11111111 1111111 111111111111