



EA textures/wall.png
NO textures/wall.png




C       42,42,53

F 41,39,32

SO textures/wall.png


WE textures/wall.png



1111111111111111111111111   1111
100000000011000000000000111110101
1D11000001110000000000000000N00011
100100000000000000000000000000001111
1111111111111011000001110001D10000001
10000000001100000111011111111D1111111
11110111111111011101D1001000D1
11110111111111011100000010001
11000000110101011100000010001
10000000000000001100000010001
10000000000000001101D100D0001
1100000111010101111101111000111
11110111 1110101 1011110100D1    1
    1       1 1   1    1 111
11111111 1111111 111111111111      

